1111111111111111
1000000111000001
1000000000001101
10011000000C0001
1000000011000001
1P0011E000000C01
1000001000000001
1001100000111001
10000C0000001001
1111111111111111