1111111111111
10010000000C1
1000000111001
100011EP01001
1111111111111