11111111111111111
10000001110000001
10000000000011001
10011000000C00001
10000000110000001
1P0011E000000C001
10000010000000001
10011000001110001
10000C00000010001
10000C00000010001
11111111111111111